0000000000000000000000000000000000000000000000000000000000000000
0000000000000000000000000000000000000000000000000000000000000000
0000000000000000000000000000000000000000000000000000000000000000
0000000000000000000000000000000000000000000000000000000000000000
0000000000000000000000000000000000000000000000000000000000000000
0000000000000000000000000000000000000000000000000000000000000000
1000000000000000000000000000000000000000000000000000000000000000
2000000000000000000000000000000000000000000000000000000000000000
2100000000000000000000000000000000000000000000000000000000000000
2211000000000000000000000000000000000000000000000000000000000000
3222100000000000000000000000000000000000000000000000000000000000
3222200000000000000000000000000009000000000000000000000000000000
3322210000000000000000000000000009000000000000000000000000000000
3333221000000000000000000000000009000000000000000000000000000000
3333322110000004567800000000011111111111000000000000000000000111
3333322221110000000000000111122222222222100000000001111111111222
3333332222221111111111111222222222222222211000011112222222222222
3333333222222222222222222222222222222222222111122222222222222222
3333333332222222222222222222233333333333222222222222222222222333
3333333333332222222222222333333333333333322222222223333333333333
3333333333333333333333333333333333333333333222233333333333333333
3333333333333333333333333333333333333333333333333333333333333333
3333333333333333333333333333333333333333333333333333333333333333
3333333333333333333333333333333333333333333333333333333333333333
3333333333333333333333333333333333333333333333333333333333333333
3333333333333333333333333333333333333333333333333333333333333333
3333333333333333333333333333333333333333333333333333333333333333
3333333333333333333333333333333333333333333333333333333333333333
3333333333333333333333333333333333333333333333333333333333333333
3333333333333333333333333333333333333333333333333333333333333333
3333333333333333333333333333333333333333333333333333333333333333
3333333333333333333333333333333333333333333333333333333333333333