00000000000000000000000000000000000000000000000000000000000000000000000000000000000000000000000000000000000000000000000000000000
00000000000000000000000000000000000000000000000000000000000000000000000000000000000000000000000000000000000000000000000000000000
00000000000000000000000000000000000000000000000000000000000000000000000000000000000000000000000000000000000000000000000000000000
00000000000000000000000000000000000000000000000000000000000000000000000000000000000000000000000000000000000000000000000000000000
00000000000000000000000000000000000000000000000000000000000000000000000000000000000000000000000000000000000000000000000000000000
00000000000000000000000000000000000000000000000000000000000000000000000000000000000000000000000000000000000000000000000000000000
10000000000000000000000000000000000000000000000000000000000000000000000000000000000000000000000000000000000000000000000000000000
20000000000000000000000000000000000000000000000000000000000000000000000000000000000000000000000000000000000000000000000000000000
21000000000000000000000000000000000000000000000000000000000000000000000000000000000000000000000000000000000000000000000000000000
22110000000000000000000000000000000000000000000000000000000000000000000000000000000000000000000000000000000000000000000000000001
32221000000000000000000000000000000000000000000000000000000000000000000000000000000000000000000000000000000000000000000000000112
32222000000000000000000000000000000000000000000000000000000000000000000000000000000000000000000000000000000000000000000000001222
33222100000000000000000000000000000000000000000000000000000000000000000000000000000000000000000000000000000000000000000000012222
33332210000000000000000000000000000000000000000000000000000000000000000000000000000000000111111111000000000000000000000000022223
33333221100000000000000000000111111111110000000000000000000001111111111111111111111111111222222222111000000000000000000000122333
33333222211100000000000001111222222222221000000000011111111112222222222222222222222222222222222222222110000000000000000011223333
33333322222211111111111112222222222222222110000111122222222222222222222222222222222222222222222222222221000000000000111122233333
33333332222222222222222222222222222222222221111222222222222222222222222222222222222222222333333333222222111000000111222222233333
33333333322222222222222222222333333333332222222222222222222223333333333333333333333333333333333333333222222111111222222222333333
33333333333322222222222223333333333333333222222222233333333333333333333333333333333333333333333333333332222222222222222233333333
33333333333333333333333333333333333333333332222333333333333333333333333333333333333333333333333333333333222222222222333333333333
33333333333333333333333333333333333333333333333333333333333333333333333333333333333333333333333333333333333222222333333333333333
33333333333333333333333333333333333333333333333333333333333333333333333333333333333333333333333333333333333333333333333333333333
33333333333333333333333333333333333333333333333333333333333333333333333333333333333333333333333333333333333333333333333333333333
33333333333333333333333333333333333333333333333333333333333333333333333333333333333333333333333333333333333333333333333333333333
33333333333333333333333333333333333333333333333333333333333333333333333333333333333333333333333333333333333333333333333333333333
33333333333333333333333333333333333333333333333333333333333333333333333333333333333333333333333333333333333333333333333333333333
33333333333333333333333333333333333333333333333333333333333333333333333333333333333333333333333333333333333333333333333333333333
33333333333333333333333333333333333333333333333333333333333333333333333333333333333333333333333333333333333333333333333333333333
33333333333333333333333333333333333333333333333333333333333333333333333333333333333333333333333333333333333333333333333333333333
33333333333333333333333333333333333333333333333333333333333333333333333333333333333333333333333333333333333333333333333333333333
33333333333333333333333333333333333333333333333333333333333333333333333333333333333333333333333333333333333333333333333333333333