0000000000000000000000000000000000000000000000000000000000000000
0000000000000000000000000000000000000000000000000000000000000000
0000000000000000000000000000000000000000000000000000000000000000
0000000000000000000000000000000000000000000000000000000000000000
0000000000000000000000000000000000000000000000000000000000000000
0000000000000000000000000000000000000000000000000000000000000000
1000000000000000000000000000000000000000000000000000000000000000
2000000000000000000000000000000000000000000000000000000000000000
2100000000000000000000000000000000000000000000000000000000000000
2211000000000000000000000000000000000000000000000000000000000000
3222100000000000000000000000000000000000000000000000000000000000
3222200000000000000000000000000009000000000000000000000000000000
3322210000000000000000000000000009000000000000000000000000000000
3333221000000000000000000000000009000000000000000000000000000000
3333322110000000000000000000011111111111000000000000000000000111
3333322221110000000000000111122222222222100000000001111111111222
3333332222221111111111111222222222222222211000011112222222222222
3333333222222222222222222222222222222222222111122222222222222222
3333333332222222222222222222233333333333222222222222222222222333
3333443433332222222222222333333333333333322222222223333333343333
3334444443333333333333333333335555333333333222233333333344443333
3333344333333333334433333333333533333334433333353333333344433333
3333333333333333344444333333333333333444443333335555333333333333
3333333555553333333333333333333333333344333333333353336633333333
3333333335533333333333366633333333333333333333333333333666633333
3377733333333333333333366663333333333333333333333333333333663333
3773333333333333333333333333333333333333333777733333333333333333
3333333333333333333333333333333333333333337777777333333333883333
3333333383333333333333333333333333333333333333333333333333338333
3333333888833333333333333333333388333333333333333333333333333333
3333333333383333333333333333333338888883333333333333333333333333
3333333333333333333333333333333333333333333333333333333333333333